Xu, Xu, Xu, Xu, Xu, Xu, Xu, Xu, Xu, Xu, Xu, Xu, Xu, Xu, Wo, Wo, Uh^Emf, Wwf, Uh^Em, Xu, Xu, Xu, Xu, Xu, Xu, Xu, Xu, Xu, Xu, Xu, Xu, Xu, Xu, Xu, Xu, Xu, Xu
Xu, Xu, Xu, Xu, Xu, Xu, Xu, Xu, Xu, Xu, Xu, Xu, Xu, Xu, Uu^Uf, Ww, Wo, Wwf^Es, Xu, Xu, Xu, Xu, Xu, Xu, Xu, Xu, Xu, Xu, Xu, Xu, Xu, Xu, Xu, Xu, Xu, Xu, Xu
Xu, Xu, Xu, Xu, Xu, Xu, Xu, Xu, Xu, Xu, Xu, Xu, Xu, Uu^Emf, Uu, Wo^Ii, Wo^Ii, Uh^Emf, Uu^Em, Uu^Uf, Xu, Xu, Xu, Xu, Xu, Xu, Xu, Xu, Xu, Xu, Xu, Xu, Xu, Xu, Xu, Xu, Xu
Xu, Xu, Xu, Xu, Xu, Xu, Xu, Xu, Xu, Xu, Xu, Xu, Xu, Xu, Uh^Em, Xu, Uh, Ww, Uu^Uf, Uh^Es, Xu, Xu, Xu, Xu, Xu, Xu, Xu, Xu, Xu, Xu, Xu, Xu, Xu, Xu, Xu, Xu, Xu
Xu, Xu, Xu, Xu, Xu, Xu, Xu, Xu, Xu, Xu, Xu, Xu, Xu, Xu, Xu, Uh^Emf, Wwf^Es, Wwf^Ii, Wo^Ii, Xu, Xu, Xu, Xu, Xu, Xu, Xu, Xu, Xu, Xu, Xu, Xu, Xu, Xu, Xu, Xu, Xu, Xu
Xu, Xu, Xu, Xu, Xu, Xu, Xu, Xu, Xu, Xu, Xu, Xu, Xu, Xu, Xu, Uh, Xu, Wwf^Ii, Wo, Wo, Wwf^Es, Uu^Uf, Xu, Xu, Xu, Xu, Xu, Xu, Xu, Xu, Xu, Xu, Xu, Xu, Xu, Xu, Xu
Xu, Xu, Xu, Xu, Xu, Xu, Xu, Xu, Xu, Xu, Xu, Xu, Xu, Xu, Xu, Xu, Xoc, Xu, Uh, Ww, Xoc^Efs, Wwf, Xu, Xu, Xoc, Xu, Xu, Xu, Xu, Xu, Xu, Xu, Xu, Xu, Xu, Xu, Xu
Xu, Xu, Xu, Xu, Xu, Xu, Xu, Xu, Xu, Xu, Xu, Xu, Xu, Xu, Xoc, Xoc, Ur, Xoc, Ww^Ii, Ww^Ii, Uh^Em, Ww^Ii, Wwf^Ii, Xoc, Uu^Uf, Xoc, Xoc, Xu, Xu, Xu, Xu, Xu, Xu, Xu, Xu, Xu, Xu
Xu, Xu, Xu, Xu, Xu, Xu, Xu, Xu, Xu, Xu, Xu, Xu, Xoc, Xoc, Urb, Ur^Es, Uu^Vud, Wo, Cud^Em, Cud^Ii, 2 Kud^Ii, Cud^Ii, Cud, Wo, Uu^Vud, Ur^Em, Urb^Emf, Xoc, Xoc, Xu, Xu, Xu, Xu, Xu, Xu, Xu, Xu
Xu, Xu, Xu, Xu, Xu, Xu, Xu, Xu, Xu, Xu, Xu, Xoc, Xoc, Uu^Vud, Urb, Xoc^Efs, Ww, Wo, Urb^Eb, Cud^Ii, Urc, Cud^Ii, Urb^Eb, Wo, Wwf, Xoc^Efs, Urb, Uu^Vud, Xoc, Xu, Xu, Xu, Uh, Xuc, Xuc, Xuc, Xu
Xu, Xu, Uh^Em, Uh^Emf, Uu^Ufi, Xu, Xuc, Xu, Xu, Xu, Xuc, Xoc, Cud^Ebn, Uu^Uf, Ur^Em, Ww, Xoc^Efs, Ww, Ur^Ii, Urc, Urc^Es, Urc^Em, Ur^Ii, Ww, Xoc^Efs, Wwf^Es, Ur, Ur^Es, Cud^Ebn, Xuc, Xuc, Uh^Emf, Urb^Ii, Uu^Ufi, Uh^Ii, Uh^Es, Ur
Xu, Xuc, Uu^Uf, Uu^Ii, Uu^Emf, Xuc, Uh, Xuc, Xu, Xuc, Uh, Xuc, Urb^Emf, Cud, Urb^Es, Wo, Ur, Uu^Vud, Ur^Ii, Urc^Ii, Urc, Urc^Ii, Ur^Ii, Uu^Vud, Ur^Em, Wo, Urb^Es, Cud^Emf, Urb^Em, Uh, Cud^Ebn, Ur^Ii, Xuc, Urb^Ii, Ur^Em, Urb^Emf, Urb
Xu, Xuc, Ur^Em, Uh^Es, Urb^Ii, Uh, Ur^Ii, Ur^Emf, Urb, Urb^Em, Cud^Ebn, Ur, Ur^Es, Cud, Urb, Wo^Bsb/, Wo, Ur^Ii, Urb^Ii, Urc^Es, 1 Cud, Urc, Urb^Ii, Ur^Ii, Wo, Wo^Bsb\, Urb, Cud, Xuc, Ur, Xu, Urb^Ii, Uu^Uf, Uh^Emf, Uh, Xu, Xu
Ur^Ii, Urb^Ii, Xuc, Ur^Emf, Urb^Ii, Urb^Ii, Uu^Ufi, Ur^Ii, Uh, Urb^Es, Uh, Uu^Uf, Xuc, Xuc, Uu^Vud, Wwf^Es, Ww, Uu^Vud, Ur^Es, Urb^Em, Ur, Urb^Emf, Ur^Em, Uu^Vud, Ww, Ww, Uu^Vud, Uh, Xu, Xu, Xu, Uu^Uf, Xu, Xu, Xu, Xu, Xu
Ur^Emf, Urb^Ii, Urb^Es, Xuc, Uh, Uu^Em, Uu^Uf, Uu^Uf, Xuc, Uu, Xu, Uh, Xuc, Xu, Qxu, Ww, Ww, Xoc^Efs, Uu^Vud, Ur, Ur, Ur^Es, Uu^Vud, Xoc^Efs, Qxu, Ww, Qxu, Qxu, Xu, Xu, Xu, Xu, Uh^Emf, Xu, Xu, Xu, Xu
Xu, Uh, Xuc, Uu^Uf, Xu, Uh^Emf, Uh, Xu, Xu, Xu, Xu, Xuc, Xu, Xu, Qxu, Qxu, Qxu, Urb, Urb^Em, Ur, Urb, Ur, Uu^Uf, Qxu, Qxu, Qxu, Qxu^Ii, Qxu^Ii, Qxu^Ii, Ww, Uh^Ii, Xu, Uh^Ii, Uh^Em, Ww^Ii, Uu^Uf, Uh^Em
Xu, Xuc, Xu, Xuc, Xu, Uh, Xu, Xu, Xu, Xu, Xu, Xu, Xu, Qxu, Qxu^Ii, Qxu, Qxu^Ii, Cud^Em, Urb^Emf, Cud, Urb^Ebn, Cud, Urb, Cud^Es, Xu, Qxu, Xu, Qxu^Ii, Xu, Wwf^Ii, Ww^Ii, Wo, Ww^Ii, Wo^Ii, Wo, Uh, Wo^Ii
Xu, Xu, Xu, Xu, Xu, Xu, Xu, Xu, Uh^Emf, Xu, Uu^Uf, Xu, Uh^Emf, Wwf, Wo^Ii, Ww^Ii, Xu, Xu, Urb^Em, Ur, Urb^Em, Ur, Urb^Emf, Uh, Xu, Xu, Xu, Xu, Xu, Uh^Emf, Uh, Uu^Uf, Uu^Emf, Wo, Xu, Ww^Ii, Xu
Xu, Xu, Xu, Xu, Xu, Xu, Xu, Xu, Uu^Es, Uh^Ii, Uu^Ufi, Wo, Wo, Ww^Ii, Xu, Wo^Ii, Xu, Xu, Xuc, Urb^Es, Uu^Uf, Urb, Ur, Xuc, Xuc, Xu, Xu, Xu, Xu, Xu, Xu, Xu, Uu^Uf, Uu^Uf, Xu, Xu, Xu
Xu, Xu, Xu, Xu, Xu, Xu, Xu, Uu^Uf, Wwf^Ii, Uh^Ii, Wo, Wo, Wwf^Es, Wwf, Uh^Emf, Xu, Xu, Xu, Uh, Uu, Uh, Ur^Es, Urb^Ii, Xuc, Uh^Ii, Xu, Xu, Xu, Xu, Xu, Xu, Xu, Xu, Xu, Xu, Xu, Xu
Xu, Xu, Xu, Xu, Xu, Xu, Uh, Wwf^Es, Uh, Ww^Ii, Uu^Emf, Xu, Xu, Qxu, Xu, Xu, Xu, Xu, Xu, Uh^Emf, Xuc, Urb, Ur^Es, Ur^Ii, Urb^Em, Uu^Emf, Xuc, Xu, Xu, Xu, Xu, Xu, Xu, Xu, Xu, Xu, Xu
Xu, Xu, Xu, Xu, Xu, Xu, Wo, Wo, Uh, Xu, Xu, Xu, Xu, Xu, Xu, Xu, Xu, Xu, Xu, Xu, Xu, Uh, Xu, Uu^Uf, Uu, Uh, Xuc, Xuc, Xu, Xu, Xu, Xu, Xu, Xu, Xu, Xu, Xu
