Xu, Xu, Urb, Uu, Urb^Ii, Xu, Xu, Xu, Xu, Xu, Xu, Xu, Xu, Xu, Xu, Xu, Xu, Xu, Xu, Xu, Xu, Xu, Xu, Xu, Xu, Xu, Xu, Xu, Xu, Xu, Xu, Xu, Xu, Xu, Xu, Xu, Xu, Xu, Xu, Xu, Xu, Xu, Xu, Xu, Xu, Xu
Xu, Xuc, Uu^Uf, Urb^Ii, Ur^Ii, Uh, Xuc, Xu, Uu^Uf, Xu, Uu^Emf, Xu, Xu, Xu, Xu, Xu, Xu, Xu, Xu, Xu, Xu, Xu, Xu, Xu, Xu, Xu, Xu, Xu, Xu, Xu, Xu, Xu, Xu, Xu, Xu, Xu, Xu, Xu, Xu, Xu, Xu, Xu, Xu, Xu, Xu, Xu
Wwf, Uh^Em, Uu^Es, 1 Ur^Emf, Ur^Ii, Xuc, Xu, Xu, Xu, Uu^Uf, Xu, Xu, Wwf^Es, Xu, Xu, Xu, Xu, Xu, Uh^Emf, Xu, Xu, Xu, Xu, Xu, Xu, Xu, Xu, Xu, Xu, Xu, Xu, Xu, Xu, Xu, Xu, Xu, Xu, Xu, Xu, Xu, Xu, Xu, Xu, Xu, Xu, Xu
Uh, Wwf^Es, Sm, Wwf^Ii, Wwf, Uu^Uf, Ww, Uh, Wo, Uh^Es, Wo, Uu^Uf, Ww, Xu, Uh^Ii, Xu, Wo, Xu, Uh^Es, Uu^Em, Ww, Xu, Xu, Xu, Xu, Xu, Xu, Xu, Xu, Xu, Xu, Xu, Xu, Xu, Xu, Xu, Xu, Xu, Xu, Xu, Xu, Xu, Xu, Xu, Xu, Xu
Xu, Wwf, Uu^Uf, Uh^Ii, Urb^Em, Ww, Xu, Ww, Uh^Emf, Wo, Wwf, Wwf^Es, Wwf^Es, Ww, Wo^Ii, Ww^Ii, Wo^Ii, Wo, Wwf^Ii, Wwf^Ii, Uu^Uf, Ww, Xu, Xu, Xu, Xu, Xu, Xu, Xu, Xu, Xu, Xu, Xu, Xu, Xu, Xu, Xu, Xu, Xu, Xu, Xu, Xu, Xu, Xu, Xu, Xu
Xu, Xu, Ur^Ii, Urb^Ii, Xuc, Uh, Xuc, Xu, Xu, Xu, Xu, Xu, Uh^Em, Uu^Emf, Xu, Ww, Xu, Wo, Ww, Uh^Ii, Wo^Ii, Ww, Ww, Xu, Xu, Xu, Xu, Xu, Xu, Xu, Xos, Xu, Xu, Xu, Xu, Xu, Xu, Xu, Xu, Xu, Xu, Xu, Xu, Xu, Xu, Xu
Xuc, Xuc, Ur, Uh, Cud^Ii, Uu^Emf, Uh, Xuc, Xu, Xu, Xu, Xu, Xu, Xu, Xu, Xu, Xu, Uh, Xu, Wo^Ii, Ww^Ii, Wo, Xu, Xu, Xu, Xu, Xu, Xu, Xos, Xos, Xos, Xos, Xos, Xu, Xu, Xu, Xu, Xu, Xu, Xu, Xu, Xu, Xu, Xu, Xu, Xu
Xuc, Xuc, Urb, Urb, Kud^Ii, Cud^Ii, Uu, Xuc, Xu, Xu, Xu, Xu, Xu, Xu, Xu, Xu, Xuc, Xu, Xu, Ww, Wo, Xu, Xuc, Xu, Xu, Xu, Xos, Xos, Uh^Em, Urb^Es, Uh^Vov, Uh^Emf, Ur, Xos, Xos, Xu, Xu, Xu, Xu, Xu, Xu, Xu, Xu, Xu, Xu, Xu
Xuc, Uu^Uf, Ur^Ii, Cud^Es, Uh^Br|, Cud, Uh, Xuc, Xuc, Xu, Xu, Xu, Xuc, Xu, Xu, Xuc, Wwf^Ii, Uu^Emf, Uh^Em, Uh^Eb, Xuc, Ww, Xuc, Xu, Xu, Xos, Uh^Emf, Kud, Cud, Urb^Ii, Urb^Ii, Urb^Em, Uu^Ufi, Uu^Em, Uh, Xos, Xu, Xu, Xu, Xu, Xu, Xu, Xu, Xu, Xu, Xu
Xuc, Uu^Vud, Urb, Urb, Uh^Br\, Uu^Uf, Uh^Br/, Cud^Emf, Ur^Es, Uu^Vud, Uu^Uf, Xuc, Uu^Es, Uh, Ur, Ww, Uu^Ii, Uu^Ufi, Ur^Es, Sm, Ur^Emf, Wwf^Es, Sm, Xuc, Uh, Xu, Uh^Em, Uu^Uf, Uh, Wwf^Ii, Ur, Ur^Ii, Xos, Uh, Sm, Xos, Xos, Xu, Xu, Xu, Xu, Xu, Xu, Xu, Xu, Xu
Xu, Xuc, Xuc, Ur^Ii, Uh^Ii, Uh^Br|, Uu^Uf, Uh^Br\, Uh^Br\, Ur^Emf, Uh^Br\, Ur, Ur^Em, Ur^Emf, Sm, Uh^Ii, Uu^Uf, Wwf^Ii, Xu, Wwf, Ww, Sm^Bw\r, Ur^Emf, Ur, Ur^Em, Uu^Ufi, Uu, Urb, Uu^Uf, Urb^Eb, Uh^Ii, Uh, Ur, Ur, Ur^Ii, Ur^Emf, Sm, Xos, Xu, Xu, Xu, Xu, Xu, Xu, Xu, Xu
Xu, Xuc, Ur, Urb^Ii, Uu^Vud, Cud^Em, Xuc, Xuc, Xu, Uh^Br/, Uu, Uh^Br\, Uh^Br\, Xuc, Xu, Xuc, Xu, Xu, Ww, Ww, Uu^Uf, Uh, Xu, Uh, Xu, Uu^Emf, Urb^Ii, Uh^Vov, Urb, Uh^Emf, Uu^Ufi, Uu^Emf, Wwf^Es, Urb^Em, Ur, Sm^Ii, Sm, Xos, Xu, Xu, Xu, Xu, Xu, Xu, Xu, Xu
Xu, Xu, Urb^Es, Ur, Uh^Br/, Uh^Br|, Xuc, Xu, Xu, Xu, Xuc, Wwf, Uh^Br|, Xu, Xuc, Xuc, Uh^Em, Xu, Uh, Wo, Wo, Xu, Xuc, Xu, Xoc, Uu^Uf, Ur^Ii, Urb^Ii, Ur^Ii, Uu^Ii, Uh^Emf, Uh, Wwf, Xos^Efs, Uh, Wwf, Wwf^Es, Xos, Xu, Xu, Xu, Xu, Xu, Xu, Xu, Xu
Qxu, Xu, Uu^Uf, Uh^Br|, Uu^Uf, Xuc, Qxu, Xu, Xu, Xu, Xu, Uh, Uu^Uf, Uh^Br\, Sm^Ii, Uh^Emf, Uu^Uf, Xu, Uu^Ufi, Ww, Ww, Uh, Xuc, Xu, Xoc, Ur^Ii, Urb, Xos^Efs, Sm, Uu^Uf, Urb^Ii, Urb^Ii, Ur^Ii, Ur^Ii, Urb^Emf, Urb^Em, Urb, Xos, Xu, Xu, Xu, Xu, Xu, Xu, Xu, Xu
Qxu, Uh^Emf, Uu^Ufi, Qxu^Ii, Qxu, Uh^Emf, Qxu, Qxu, Xu, Xu, Xu, Xu, Xu, Ww^Ii, Wwf, Uh^Br\, Uh^Br|, Uu^Ii, Uu^Uf, Uh, Ww, Uu^Uf, Uh^Emf, Xu, Xoc, Urb^Emf, Uh^Vov, Wwf, Ur^Em, Ur^Ii, Ur^Ii, Uh, Ur^Ebn, Ur, Uh, Uh^Vov, Urb, Xos, Xu, Xu, Xu, Xu, Xu, Xu, Xu, Xu
Xuc, Qxu, Qxu^Ii, Qxu^Ii, Qxu^Ii, Qxu, Xu, Qxu, Xu, Xu, Xu, Xu, Xu, Uh^Emf, Xu, Xu, Uh^Br\, Wwf, Wwf^Es, Wwf, Xu, Uu, Rb^Em, Xuc, Xos, Urb, Uu^Emf, Urb, Sm^Ii, Wwf^Es, Ur, Ur, Urb^Es, Uu^Uf, Uu^Emf, Uu^Emf, Xos, Xos, Xu, Xu, Xuc, Xu, Ss, Xu, Xu, Xu
Xu, Xuc, Ur^Emf, Qxu^Ii, Uu^Uf, Xu, Xu, Xu, Xu, Xu, Xu, Xu, Xu, Xu, Xu, Wwf^Es, Ww, Ww, Wwf, Xu, Xu, Uh, Rb, Xuc, Xos^Efs, Xos, Urb, Uu^Uf, Uh^Ii, Wwf^Ii, Uu^Uf, Ur, Urb, Uh^Vov, Sm, Ur^Em, Xos, Xos^Efs, Uu^Em, Xuc, Uh^Emf, Wwf, Xu, Sm, Xu, Xu
Uu^Uf, Xuc, Uh^Br/, Uh^Ii, Xuc, Xu, Xu, Xu, Xu, Xu, Xu, Xu, Xu, Xu, Ww, Ww, Wo, Wo, Uh^Br\, Xu, Xu, Xu, Uu^Uf, Rb^Emf, Uu^Uf, Urb^Pr\o, Urb^Pr\o, Ur, Xos, Uh, Uh^Emf, Uh, Ur, Urb^Emf, Xos, Urb^Pr/o, Uu, Uh, Uu^Uf, Uh, Uh, Ss^Vhs, Wwf^Ii, Wwf^Ii, Ss, Xu
Uh, Uh^Br/, Uu^Uf, Uh^Emf, Uh, Xuc, Xu, Xu, Xu, Xu, Xu, Xu, Xu, Uh^Em, Uh, Ww, Ww, Wo, Uu^Uf, Uh^Br\, Xuc, Xu, Xu, Uu^Em, Uh^Em, Rb^Es, Rb^Ii, Xos, Xos, Xos, Xos, Xos, Xos, Xos, Xu, Xu, Xuc, Rb^Es, Rb^Ii, Uu^Ii, Sm, Sm^Ii, Sm^Ii, Xu, Xu, Xu
Uh^Br/, Uh^Br|, Urb^Ii, Ur, Xu, Xuc, Xu, Xu, Xu, Xu, Xu, Xu, Xu, Xu, Wwf, Wwf^Es, Uh^Emf, Ww, Wwf^Ii, Uh^Br|, Uh^Br\, Xuc, Xu, Uh, Rb, Rb^Ii, Uu^Ii, Xu, Xuc, Xos, Xuc, Xu, Xu, Xu, Xu, Xuc, Xuc, Uh, Rb^Emf, Xuc, Xu, Ss, Ss, Ss, Xu, Xu
Urb, Ur^Es, Ur^Em, Uh^Ii, Uu^Ufi, Xu, Xu, Xu, Xu, Xu, Xu, Xu, Xu, Xu, Xu, Uh, Xu, Xu, Ww, Wo^Ii, Uh^Br|, Xuc, Xu, Xuc, Rb^Es, Uu^Uf, Uh^Ii, Uh, Uu^Emf, Xuc, Uh, Uh, Rb^Vct, Xuc, Uh^Es, Uu^Emf, Uu, Rb^Ii, Uu, Xuc, Xu, Xu, Xu, Xu, Xu, Xu
Xu, Urb^Emf, Xuc, Uu^Ufi, Xuc, Xu, Xu, Xu, Xu, Xu, Xu, Xu, Xu, Xu, Xu, Xu, Xu, Xu, Uh, Wo^Ii, Ww, Uh^Br\, Uu^Uf, Xuc, Sm, Sm, Uh, Uu^Emf, Uu, Rb^Vct, Ce^Es, 2 Ket, Ce^Em, Uu, Xuc, Rb^Em, Uu, Uu^Uf, Xuc, Xuc, Xu, Xu, Xu, Xu, Xu, Xu
Xu, Uh, Xu, Xuc, Xu, Xu, Xu, Xu, Xu, Xu, Xu, Xu, Xu, Xu, Xu, Xu, Xu, Xu, Xu, Ww, Uu^Emf, Uh^Br|, Wwf^Es, Uh^Em, Ww^Bsb/, Wwf^Bsb/, Wo, Ww, Xu, Uu^Uf, Uu, Ce, Uh^Ecf, Rb, Xuc, Xu, Xu, Xu, Xu, Xu, Xu, Xu, Xu, Xu, Xu, Xu
Xu, Xu, Xu, Xu, Xu, Xu, Xu, Xu, Xu, Xu, Xu, Xu, Xu, Xu, Xu, Xu, Xu, Xu, Xu, Xu, Uh^Br|, Uh^Br/, Sm^Ii, Wwf^Ii, Xu, Wo, Xu, Wo, Ww, Xu, Xuc, Uu^Uf, Uh^Emf, Rb^Es, Rb, Xu, Uu^Ufi, Xu, Xu, Xu, Xu, Xu, Xu, Xu, Xu, Xu
Xu, Xu, Xu, Xu, Xu, Xu, Xu, Xu, Xu, Xu, Xu, Xu, Xu, Xu, Xu, Xu, Xu, Xu, Xu, Uu^Uf, Uh^Br|, Rb, Uh, Xu, Xu, Xu, Ww, Wo, Ww, Xu, Xu, Uh, Uh, Uu^Em, Uu, Uh, Xu, Xu, Xu, Xu, Xu, Xu, Xu, Xu, Xu, Xu
