Xu, Xu, Ur, Uu, Uu, Xu, Xu, Xu, Xu, Xu, Xu, Xu, Xu, Xu, Xu, Xu, Xu, Xu, Xu, Xu, Xu, Xu, Xu, Xu, Xu, Xu, Xu, Xu, Xu, Xu, Xu, Xu, Xu, Xu, Xu, Xu, Xu, Xu, Xu, Xu, Xu, Xu, Xu, Xu, Xu, Xu
Xu, Xu, Uu, Ur, Uh, Xu, Xu, Xu, Xu, Xu, Xu, Xu, Xu, Xu, Xu, Xu, Xu, Xu, Xu, Xu, Xu, Xu, Xu, Xu, Xu, Xu, Xu, Xu, Xu, Xu, Xu, Xu, Xu, Xu, Xu, Xu, Xu, Xu, Xu, Xu, Xu, Xu, Xu, Xu, Xu, Xu
Xu, Xu, Uu, 1 Ur, Ur, Xu, Xu, Xu, Xu, Xu, Xu, Xu, Xu, Xu, Xu, Xu, Xu, Xu, Xu, Xu, Xu, Xu, Xu, Xu, Xu, Xu, Xu, Xu, Xu, Xu, Xu, Xu, Xu, Xu, Xu, Xu, Xu, Xu, Xu, Xu, Xu, Xu, Xu, Xu, Xu, Xu
Xu, Xu, Xu, Uu, Ur, Uu^Uf, Uh, Xu, Xu, Xu, Xu, Xu, Xu, Xu, Xu, Xu, Xu, Xu, Xu, Xu, Xu, Xu, Xu, Xu, Xu, Xu, Xu, Xu, Xu, Xu, Xu, Xu, Xu, Xu, Xu, Xu, Xu, Xu, Xu, Xu, Xu, Xu, Xu, Xu, Xu, Xu
Xu, Xu, Xu, Uh, Ur, Uu, Xu, Xu, Xu, Xu, Xu, Xu, Xu, Xu, Xu, Xu, Xu, Xu, Xu, Xu, Xu, Xu, Xu, Xu, Xu, Xu, Xu, Xu, Xu, Xu, Xu, Xu, Xu, Xu, Xu, Xu, Xu, Xu, Xu, Xu, Xu, Xu, Xu, Xu, Xu, Xu
Xu, Xu, Ur, Ur, Xos, Uh, Xos, Xu, Xu, Xu, Xu, Xu, Xu, Xu, Xu, Xu, Xu, Xu, Xu, Xu, Xu, Xu, Xu, Xu, Xu, Xu, Xu, Xu, Xu, Xu, Xoc, Xu, Xu, Xu, Xu, Xu, Xu, Xu, Xu, Xu, Xu, Xu, Xu, Xu, Xu, Xu
Xu, Xu, Ur, Xos, Cud, Xos, Uh, Xos, Xu, Xu, Xu, Xu, Xu, Xu, Xu, Xu, Xu, Xu, Xu, Xu, Xu, Xu, Xu, Xu, Xu, Xu, Xu, Xu, Xoc, Xoc, Uu, Xoc, Xoc, Xu, Xu, Xu, Xu, Xu, Xu, Xu, Xu, Xu, Xu, Xu, Xu, Xu
Xos, Xos, Uu^Uf, Uu, Kud, Cud, Uu^Vud, Xos, Xu, Xu, Xu, Xu, Xu, Xu, Xu, Xu, Xu, Xu, Xu, Xu, Xu, Xu, Xu, Xu, Xu, Xu, Xoc, Xoc, Uu, Uu, Uu^Vov, Uu^Uf, Uu, Xoc, Xoc, Xu, Xu, Xu, Xu, Xu, Xu, Xu, Xu, Xu, Xu, Xu
Xos, Uu^Uf, Uu^Uf, Cud, Ur^Br|, Cud, Uh, Xos, Xu, Xu, Xu, Xu, Xu, Xu, Xu, Xu, Uu, Uu, Uu, Xu, Uu, Xu, Xu, Xu, Xu, Xu, Xoc, Uu, Uu, Uh, Urb, Urb, Urb, Uu, Uu, Xoc, Xu, Xu, Xu, Xu, Xu, Xu, Xu, Xu, Xu, Xu
Xos, Uu^Vud, Uu, Uu, Ur^Br\, Uu^Uf, Ur, Cud, Ur, Uu, Uh, Xu, Uu, Uh, Uu, Uu, Rb, Ur, Rb, Ur, Ur, Uu, Uu, Xu, Xoc, Xoc, Uh, Uh, Uu, Uu^Uf, Urb, Uu, Urb, Uu, Uu, Xoc, Xoc, Xu, Xu, Xu, Xu, Xu, Xu, Xu, Xu, Xu
Xu, Xos, Xos, Uu^Vud, Xos, Ur^Br|, Xos, Xos, Uu, Ur, Ur, Ur, Rb, Rb, Ur, Ur, Uu^Uf, Uu, Xu, Uu, Uh, Rb, Rb, Uu, Rb, Uu, Uu^Uf, Uu^Uf, Urb, Uu, Urb, Uu, Urb, Urb, Uu, Uu^Uf, Uu, Xoc, Xu, Xu, Xu, Xu, Xu, Xu, Xu, Xu
Xu, Xu, Xu, Xos, Uu, Cud, Xu, Xu, Xu, Xu, Xu, Uu, Uu, Uu, Xu, Uu, Xu, Xu, Xu, Xu, Uu^Uf, Xu, Xu, Rb, Xoc, Urb, Urb, Uu^Vov, Uu^Uf, Urb, Uu, Urb, Uh, Urb, Urb, Uu^Uf, Uu, Xoc, Xu, Xu, Xu, Xu, Xu, Xu, Xu, Xu
Xu, Xu, Xu, Xu, Ur^Br/, Ur^Br|, Xu, Xu, Xu, Xu, Xu, Xu, Uu^Uf, Xu, Uh, Xu, Uh, Xu, Uu^Uf, Xu, Uu, Xu, Xu, Xu, Xoc, Uu^Uf, Uu, Urb, Urb, Uh, Uh, Uu, Uu, Uu, Uu, Urb, Urb, Xoc, Xu, Xu, Xu, Xu, Xu, Xu, Xu, Xu
Xu, Xu, Uu^Dr, Ur^Br|, Uu^Dr, Xu, Qxu, Xu, Xu, Xu, Xu, Xu, Xu, Uh, Uh, Uu^Uf, Uu^Uf, Xu, Uu^Uf, Uh, Uh, Uh, Xu, Xu, Xoc, Uh, Uh, Uu^Uf, Urb, Urb, Urb, Urb, Urb, Uu, Urb, Urb, Uu, Xoc, Xu, Xu, Xu, Xu, Xu, Xu, Xu, Xu
Xu, Qxu, Qxu, Uu^Dr, Uu^Dr, Uu^Dr, Qxu, Xu, Xu, Xu, Xu, Xu, Xu, Xu, Xu, Uu^Uf, Xu, Uu, Uu^Uf, Uh, Xu, Uu^Uf, Uh, Xu, Xoc, Uu, Uu^Vov, Uu, Urb, Uu^Uf, Uh, Uu, Uu^Uf, Urb, Urb, Uu^Vov, Uu, Xoc, Xu, Xu, Xu, Xu, Xu, Xu, Xu, Xu
Xu, Qxu, Qxu, Qxu, Qxu, Qxu, Xu, Xu, Xu, Xu, Xu, Xu, Xu, Xu, Xu, Xu, Xu, Xu, Xu, Xu, Xu, Uu, Uu, Uh, Xoc, Uu, Uu, Urb, Uu, Uu^Uf, Uu, Uh, Uh, Uu, Urb, Uu, Xoc, Xoc, Xu, Xu, Xu, Xu, Xu, Xu, Xu, Xu
Xu, Xu, Uu, Uu^Dr, Uu^Dr, Xu, Xu, Xu, Xu, Xu, Xu, Xu, Xu, Xu, Xu, Xu, Xu, Xu, Xu, Xu, Xu, Uu, Uu, Uh, Xoc, Uh, Urb, Urb, Uu, Uu, Uu, Uu, Uh, Uu^Vov, Urb, Uu^Uf, Xoc, Uu, Uu, Xu, Rb, Xu, Xu, Xu, Xu, Xu
Xu, Uu, Ur^Br/, Ur^Br|, Xu, Xu, Xu, Xu, Xu, Xu, Xu, Xu, Xu, Xu, Xu, Xu, Xu, Xu, Xu, Xu, Xu, Xu, Uu^Uf, Uh, Uu^Uf, Urb^Pr\o, Urb^Pr\o, Uu, Uu, Uu^Uf, Uh, Uu, Uu, Uu, Xoc, Urb^Pr/o, Uu, Uh, Rb^Vct, Uh, Uu, Rb, Xu, Xu, Xu, Xu
Uu, Ur^Br|, Uu, Xu, Xu, Xu, Xu, Xu, Xu, Xu, Xu, Xu, Xu, Xu, Xu, Xu, Xu, Xu, Xu, Xu, Xu, Xu, Xu, Uu, Uh, Rb, Uu, Xoc, Xoc, Uh, Xoc, Xoc, Xoc, Xoc, Xu, Xu, Xu, Rb, Rb, Uu, Xu, Xu, Xu, Xu, Xu, Xu
Ur^Br/, Ur^Br/, Uu, Xu, Xu, Xu, Xu, Xu, Xu, Xu, Xu, Xu, Xu, Xu, Xu, Xu, Xu, Xu, Xu, Xu, Xu, Xu, Xu, Uh, Ur, Ur, Uu, Xu, Xu, Xoc, Xu, Xu, Xu, Xu, Xu, Xu, Xu, Uu, Rb, Xu, Xu, Xu, Xu, Xu, Xu, Xu
Xu, Uu, Xu, Xu, Xu, Xu, Xu, Xu, Xu, Xu, Xu, Xu, Xu, Xu, Xu, Xu, Xu, Xu, Xu, Xu, Xu, Xu, Xu, Xu, Ur, Uu^Uf, Uh, Uh, Uu^Uf, Xu, Uh, Uh, Rb^Vct, Xu, Uh, Uu, Uu, Rb, Uu, Xu, Xu, Xu, Xu, Xu, Xu, Xu
Xu, Xu, Xu, Xu, Xu, Xu, Xu, Xu, Xu, Xu, Xu, Xu, Xu, Xu, Xu, Xu, Xu, Xu, Xu, Xu, Xu, Xu, Uu^Uf, Xu, Rb, Uu, Uu, Uu^Uf, Uu, Rb^Vct, Ce, 2 Ket, Ce, Uu, Xu, Rb, Uu, Uu^Uf, Xu, Xu, Xu, Xu, Xu, Xu, Xu, Xu
Xu, Xu, Xu, Xu, Xu, Xu, Xu, Xu, Xu, Xu, Xu, Xu, Xu, Xu, Xu, Xu, Xu, Xu, Xu, Xu, Xu, Uu, Ur, Rb, Xu, Uu, Xu, Uu, Xu, Uu^Uf, Uu, Ce, Uh, Rb, Xu, Xu, Xu, Xu, Xu, Xu, Xu, Xu, Xu, Xu, Xu, Xu
Xu, Xu, Xu, Xu, Xu, Xu, Xu, Xu, Xu, Xu, Xu, Xu, Xu, Xu, Xu, Xu, Xu, Xu, Xu, Xu, Uu, Ur, Uu, Xu, Xu, Xu, Xu, Xu, Xu, Xu, Xu, Uu^Uf, Xu, Uu, Rb, Xu, Xu, Xu, Xu, Xu, Xu, Xu, Xu, Xu, Xu, Xu
Xu, Xu, Xu, Xu, Xu, Xu, Xu, Xu, Xu, Xu, Xu, Xu, Xu, Xu, Xu, Xu, Xu, Xu, Xu, Xu, Uu, Rb, Xu, Xu, Xu, Xu, Xu, Xu, Xu, Xu, Xu, Xu, Xu, Uu, Uu, Xu, Xu, Xu, Xu, Xu, Xu, Xu, Xu, Xu, Xu, Xu
