Xu, Xu, Xu, Xu, Xu, Xu, Xuc, Xu, Xuc, Uh, Uh^Br|, Urb^Ii, Urb^Em, Xu, Xu, Xu, Xu, Xu, Xu, Xu, Xu, Xu, Xu, Xu, Xu, Xu, Xu, Xu, Xu, Xu, Xu, Xu, Xu, Xu, Xu, Xu, Xu, Xu, Xu, Xu, Xu, Xu, Xu, Xu, Xu, Xu
Xu, Xu, Uh^Emf, Uu^Uf, Uh, Uh, Uh, Xuc, Uh^Em, Uu^Vud, Uh^Br/, 1 Ur, Uu^Uf, Uu, Uu^Ufi, Uh^Emf, Xu, Xu, Xu, Xu, Xu, Xu, Xu, Xu, Xu, Xu, Xu, Xu, Xu, Xu, Xu, Xu, Xu, Xu, Xu, Xu, Xu, Xu, Xu, Xu, Xu, Xu, Xu, Xu, Xu, Xu
Xu, Xu, Xuc, Uu^Emf, Uu^Ii, Uu^Emf, Cud^Em, Uu^Uf, Cud^Ii, Uh^Br|, Uu^Uf, Urb^Ii, Uu^Ufi, Uu^Emf, Uu^Uf, Qxu, Xuc, Xu, Xu, Xu, Xu, Xu, Xu, Xu, Xu, Xu, Xu, Xu, Xu, Xu, Xu, Xu, Xu, Xu, Xu, Xu, Xu, Xu, Xu, Xu, Xu, Xu, Xu, Xu, Xu, Xu
Xu, Xuc, Uu^Uf, Uu^Em, Uu^Ii, Kud^Ii, Cud^Emf, Uh^Br\, Uh^Br\, Uh^Br/, Uu^Uf, Uu^Ufi, Uu^Ufi, Uh^Ii, Uu^Uf, Xuc, Xu, Xu, Xu, Xu, Xu, Xu, Xu, Xu, Xu, Xu, Xu, Xu, Xu, Xu, Xu, Xu, Xu, Xu, Xu, Xu, Xu, Xu, Xu, Xu, Xu, Xu, Xu, Xu, Xu, Xu
Xu, Xu, Uh, Uu^Vud, Uu, Cud, Uh, Urb^Ii, Urb^Ii, Uu^Vud, Xuc, Xu, Xu, Uh, Uu^Emf, Xu, Xu, Xu, Xu, Xu, Xu, Xu, Xu, Xu, Xu, Xu, Xu, Xu, Xu, Xu, Xu, Xu, Xu, Xu, Xu, Xu, Xu, Xu, Xu, Xu, Xu, Xu, Xu, Xu, Xu, Xu
Xu, Xu, Xu, Xu, Qxu, Uu^Uf, Urb, Ur^Ii, Uh^Emf, Qxu, Qxu, Qxu, Qxu^Ii, Qxu, Qxu^Ii, Qxu, Uh^Ii, Uh^Ii, Qxu, Xu, Xu, Xu, Xu, Xu, Xu, Xu, Xu, Xu, Xu, Xu, Xu, Xu, Xu, Xu, Xu, Xu, Xu, Xu, Xu, Xu, Xu, Xu, Xu, Xu, Xu, Xu
Xu, Xu, Qxu, Xu, Qxu, Uh, Cud^Eb, Urb^Em, Qxu^Bs\, Qxu, Qxu, Qxu^Ii, Qxu^Ii, Qxu^Ii, Qxu^Ii, Qxu^Ii, Qxu^Ii, Qxu^Ii, Qxu, Uh^Emf, Xu, Xu, Xu, Xu, Xu, Xu, Xu, Xu, Xu, Xu, Xu, Xu, Xu, Xu, Xu, Xu, Xu, Xu, Xu, Xu, Xu, Xu, Xu, Xu, Xu, Xu
Qxu, Uu^Uf, Qxu, Qxu, Qxu, Qxu, Qxu, Qxu, Uh, Ur, Ur^Emf, Qxu, Uh, Qxu^Ii, Qxu, Qxu, Qxu, Qxu, Uu^Uf, Qxu, Uu^Em, Xu, Xu, Xu, Xu, Xu, Xu, Xu, Xu, Xu, Xu, Xu, Xu, Xu, Xu, Xu, Xu, Xu, Xu, Xu, Xu, Xu, Xu, Xu, Xu, Xu
Qxu, Qxu, Qxu^Ii, Qxu, Uh^Ii, Uh, Xu, Xu, Xuc, Uu^Uf, Uu, Uh, Uu^Vu, Uu^Ufi, Qxu, Qxu, Qxu, Qxu, Uh, Xu, Xu, Xu, Xu, Xu, Xu, Xu, Xu, Xu, Xu, Xu, Xu, Xu, Xu, Xu, Xu, Xu, Xu, Xu, Xu, Xu, Xu, Xu, Xu, Xu, Xu, Xu
Qxu, Qxu^Ii, Qxu^Ii, Qxu^Ii, Xu, Qxu, Qxu, Xuc, Uu^Emf, Uu^Uf, Uu, Ur, Uu^Uf, Uu, Uu^Em, Uu, Xuc, Xu, Xu, Uh^Emf, Xu, Xu, Xu, Xu, Uu^Em, Xu, Xu, Uh, Xu, Xu, Xu, Uh^Es, Uu^Emf, Uh^Em, Uh, Xu, Xu, Xu, Xu, Xu, Xu, Xu, Xu, Xu, Xu, Xu
Xu, Xu, Qxu, Qxu, Qxu, Qxu, Qxu, Uu, Xuc, Uh, Uu^Vu, Ur^Emf, Uh^Dr, Uu^Emf, Uu, Xuc, Uh^Emf, Xue, Xu, Xu, Xu, Xu, Xu, Uh^Emf, Wwg, Wwf, Wog, Wwg^Ii, Xu, Xu, Xu, Uh, Uh^Emf, Uu^Uf, Xu, Xu, Xu, Xu, Xu, Xu, Xu, Xu, Xu, Xu, Xu, Xu
Xu, Xu, Xu, Xu, Xu, Xu, Xu, Xuc, Xu, Uh, Uu^Uf, Uu^Em, Uh^Emf, Uu, Ur^Es, Uh, Uu^Uf, Uu, Xu, Xu, Xu, Xu, Uh, Xu, Wog^Ii, Xu, Wog, Wog^Ii, Wwg, Wwg, Wwf, Wwg, Wog, Uh, Wwg, Xu, Xu, Xu, Xu, Xu, Xu, Xu, Xu, Xu, Xu, Xu
Xu, Xu, Xu, Xu, Xu, Xu, Xu, Xu, Xu, Uh, Xu, Uh, Xu, Uh, Xu, Ur, Rb, Uu^Vud, Uh, Uu^Emf, Wwf^Es, Xu, Wwg, Wog, Wog^Ii, Wwg^Ii, Uh, Wwg, Uh^Emf, Wwf^Es, Uu^Uf, Wwg, Wog, Wog, Uh, Xu, Xu, Xu, Xu, Xu, Xu, Xu, Xu, Xu, Xu, Xu
Xu, Xu, Xu, Xu, Xu, Xu, Xu, Xu, Xu, Xu, Xu, Xu, Xu, Uh, Uu^Em, Uh^Emf, Xu, Sm, Ur, Uu^Uf, Uh^Es, Uh^Emf, Wwf^Es, Wwg, Rb, Ds^Esd, Uu^Ii, Uu^Ufi, Uh^Ii, Uh^Em, Uu^Emf, Rb^Es, Uh^Emf, Wwg, Wwf^Es, Uh, Xu, Xu, Xu, Xu, Xu, Xu, Uh, Uu^Uf, Uh^Em, Xu
Xu, Xu, Xu, Xu, Xu, Xu, Xu, Xu, Xu, Xu, Xu, Xu, Xu, Xu, Uu^Es, Uu^Uf, Xu, Uu^Emf, Kud, Rb^Emf, Rb^Eb, Wwf, Wwf, Ur^Emf, Ur, Rb^Em, Uu^Es, Uu^Vu, Rb^Ii, Uu^Em, Wwg, Ds, Ds^Esd, Uh, Wwf, Xu, Wwg, Xu, Xu, Uh, Uh^Em, Xu, Xu, Wwf, Wwf, Wwf
Xu, Xu, Xu, Xu, Xu, Xu, Xu, Xu, Xu, Xu, Xu, Xu, Xu, Uh, Uu^Emf, Uu, Uu^Uf, Sm, Uu^Uf, Cud^Emf, Xu, Wwg, Wog, Ds, Ds^Esd, Uu, Uu^Emf, Uu^Uf, Ur^Ii, Rb, Ds^Esd, Ds, Uh^Emf, Uu, Wwg, Wwg, Wwg, Xu, Wwg, Uh^Es, Wwg, Wwg, Wwg, Wwg, Wog^Ii, Wog^Ii
Xu, Xu, Xu, Xu, Xu, Uh^Es, Uh^Em, Uh, Xu, Xu, Xu, Xu, Uu^Uf, Xu, Uu^Emf, Uh, Xu, Xu, Xu, Xu, Xu, Uh, Wog, Wog, Wwg, Uh, Uu^Uf, Ur^Ii, Uu^Uf, Uh^Emf, Wwf, Rb^Em, Uu^Uf, Uh^Es, Wwg, Wog, Wog, Wwg, Wog, Wwg, Wog, Wog, Wog, Wog^Ii, Wwg, Wo
Xu, Xu, Xu, Xu, Uu^Em, Uu^Uf, Uu^Uf, Uu, Uh^Emf, Xu, Xu, Uh^Em, Xu, Uh^Es, Uu^Em, Uh^Emf, Uu, Uh^Emf, Xu, Xu, Xu, Wwf^Es, Wwg, Wog, Wwg, Wwg, Ur^Em, Uh, Wwf^Es, Uh, Wog, Wwg, Wwg, Wwg, Wog^Ii, Wog^Ii, Wog, Wog^Ii, Wog^Ii, Wog^Ii, Wog, Wog, Wog, Wog, Wwg, Xu
Xu, Xu, Xu, Uh^Emf, Uu^Uf, Rb^Em, Rb^Es, Rb^Es, Uh, Xu, Xu, Xu, Xu, Uu, Qxu, Qxu, Qxu, Qxu, Qxu, Wwg, Wwg, Wwf, Uu^Uf, Wwg, Ur^Es, Wwf, Wwg, Wwf, Wwg, Wwg, Wog^Ii, Wog^Ii, Wog^Ii, Wwg, Wwg, Wog^Ii, Wwg, Wog, Wog^Ii, Wog^Ii, Wwg, Wwg, Wwg, Wwg, Uu^Emf, Xu
Xu, Xu, Xu, Xu, Uh, Uh^Es, Uu, Uu^Em, Uh^Es, Uh, Uu, Xu, Uu^Emf, Uh, Uue^Vu, Uu^Emf, Xu, Qxu, Wwg, Wog, Wog, Wwg, Rb, Ur^Em, Uh, Ds^Esd, Ds^Es, Wwg, Wog, Wwg^Ii, Wog, Wog^Ii, Wog, Wog^Ii, Xu, Wwg, Wwg, Wwg^Ii, Wwg^Ii, Wwg, Wwg, Wwg, Wwg, Wwf, Uh^Es, Uh
Xu, Xu, Xu, Xu, Xu, Uh, Xu, Xu, Xu, Uu, Xu, Uu^Uf, Uh, Uu^Es, Xu, Xu, Xu, Xu, Uu^Uf, Wog, Uh^Emf, Xu, Uh, Uu, Ur, Rb, Ds, Wwf, Wwg, Wog, Wog, Wog, Wwg, Wwg, Wwg, Xu, Uu^Em, Uu^Ufi, Uu^Uf, Wwf^Es, Wwf^Es, Xu, Xu, Xu, Xu, Xu
Xu, Xu, Xu, Xu, Xu, Xu, Xu, Xu, Xu, Xu, Xu, Xu, Uu, Uu^Em, Uu^Uf, Sm, Xu, Uh^Emf, Xu, Wwg, Uu^Vud, Xu, Xu, Uh^Em, Ur, Uh, Xu, Ds^Esd, Ds, Wwg, Wog, Wog, Uu^Es, Xu, Xu, Xu, Xu, Uh^Emf, Xu, Wwf, Xu, Xu, Xu, Xu, Xu, Xu
Xu, Xu, Xu, Xu, Xu, Xu, Xu, Xu, Xu, Xu, Xu, Uh, Xu, Uu^Emf, Wwf^Es, Wwf, Wwf^Es, Uh, Ds^Es, Wwg, Uu^Uf, Rb^Em, Xu, Rb, Ur^Emf, Rb^Es, Xu, Uu, Ds, Wwg, Wog, Wog, Uh^Em, Uh, Xu, Xu, Xu, Xu, Xu, Xu, Xu, Xu, Xu, Xu, Xu, Xu
Xu, Xu, Xu, Xu, Xu, Xu, Xu, Xu, Xu, Xu, Xu, Xu, Xu, Uh, Wwf, Ds, Ds, Ds^Esd, Wwf, Xu, Uh^Es, Xu, Uh^Ii, Uu^Ii, Rb^Ii, Xu, Wwf^Es, Rb, Wwg, Wwg, Wwg, Wwg, Xu, Xu, Xu, Xu, Xu, Xu, Xu, Xu, Xu, Xu, Xu, Xu, Xu, Xu
Xu, Xu, Xu, Xu, Xu, Xu, Xu, Xu, Xu, Xu, Xu, Xu, Xu, Sm, Wwg, Wog, Ds^Esd, Ds, Rb^Emf, Rb^Em, Xu, Uh^Em, Uu^Uf, Uh^Emf, Ur, Uu, Sm, Rb^Em, Wwg, Xu, Xu, Uh^Emf, Xu, Xu, Xu, Xu, Xu, Xu, Xu, Xu, Xu, Xu, Xu, Xu, Xu, Xu
Xu, Xu, Xu, Xu, Xu, Xu, Xu, Xu, Xu, Xu, Xu, Xu, Uu^Uf, Uh^Em, Wwg, Wog, Wo, Xu, Xu, Xu, Uu^Uf, Uu^Emf, Uu^Ufi, Ur^Ii, Wwf, Uu^Uf, Uu^Em, Ds^Es, Wwg, Xu, Uh, Uh, Xu, Xu, Xu, Xu, Xu, Xu, Xu, Xu, Xu, Xu, Xu, Xu, Xu, Xu
Xu, Xu, Xu, Xu, Xu, Xu, Xu, Xu, Xu, Xu, Xu, Xu, Xu, Uh, Xu, Wo, Wwf^Es, Wwf^Es, Uu^Uf, Ur, Rb, Ur, Wwg, Uh^Emf, Uh^Es, Uu^Uf, Ds, Ds^Esd, Wwf, Wwf, Uh, Uu^Uf, Xu, Xu, Xu, Xu, Xu, Xu, Xu, Xu, Xu, Xu, Xu, Xu, Xu, Xu
Xu, Xu, Xu, Xu, Xu, Xu, Xu, Xu, Xu, Xu, Xu, Xu, Xu, Xu, Uu^Uf, Uu^Emf, Wwf, Wwf^Es, Wwf, Rb^Em, Wog, Wwg, Uh^Emf, Wwg, Wog, Wog, Wwg, Wwg, Wwg, Wwf^Es, Xu, Xu, Xu, Xu, Xu, Xu, Xu, Xu, Xu, Xu, Xu, Xu, Xu, Xu, Xu, Xu
Xu, Xu, Xu, Xu, Xu, Xu, Xu, Xu, Xu, Xu, Xu, Uh^Emf, Uu^Ufi, Xu, Xu, Xu, Ur^Es, Uh^Emf, Uh^Es, Wog, Wwg, Wwg, Xu, Uh, Wwg, Xu, Xu, Uu^Uf, Uu, Uh^Emf, Xu, Xu, Xu, Xu, Xu, Xu, Xu, Xu, Xu, Xu, Xu, Xu, Xu, Xu, Xu, Xu
Xu, Xu, Xu, Xu, Xu, Xu, Xu, Xu, Xu, Xu, Xu, Xu, Uh^Ii, Uh^Ii, Uu, Ur, Xu, Uu, Xu, Xu, Xu, Uh, Xu, Xu, Xu, Xu, Xu, Uh, Xu, Xu, Xu, Xu, Xu, Xu, Xu, Xu, Xu, Xu, Xu, Xu, Xu, Xu, Xu, Xu, Xu, Xu
Xu, Xu, Xu, Xu, Xu, Xu, Xu, Xu, Xu, Xu, Uh, Uu^Uf, Uu^Ufi, Uu^Ufi, Ur^Es, Rb^Emf, Uh, Uh, Xu, Xu, Xu, Xu, Xu, Xu, Xu, Xu, Xu, Xu, Xu, Xu, Xu, Xu, Xu, Xu, Xu, Xu, Xu, Xu, Xu, Xu, Xu, Xu, Xu, Xu, Xu, Xu
Xu, Xu, Xu, Xu, Xu, Xu, Xu, Xu, Xu, Xu, Xu, Uu^Uf, Uh^Ii, Uu^Ufi, Ur, Uh, Uu^Uf, Xu, Xu, Xu, Xu, Xu, Xu, Xu, Xu, Xu, Xu, Xu, Xu, Xu, Xu, Xu, Xu, Xu, Xu, Xu, Xu, Xu, Xu, Xu, Xu, Xu, Xu, Xu, Xu, Xu
Xu, Xu, Xu, Xu, Xu, Xu, Xu, Xu, Xu, Xu, Ql, Qlf^Ii, Uu^Ii, Ur^Emf, Uh^Ii, Uu^Uf, Uh, Xu, Xu, Xu, Xu, Xu, Xu, Xu, Xu, Xu, Xu, Xu, Xu, Xu, Xu, Xu, Xu, Xu, Xu, Xu, Xu, Xu, Xu, Xu, Xu, Xu, Xu, Xu, Xu, Xu
Xu, Xu, Xu, Xu, Xu, Xu, Xu, Xu, Xu, Xu, Ql, Qlf^Ii, Qlf^Ii, Rb, Qlf^Ii, Ql^Ii, Ql^Ii, Ql, Qlf, Xu, Xu, Xu, Xu, Xu, Xu, Xu, Xu, Xu, Xu, Xu, Xu, Xu, Xu, Xu, Xu, Xu, Xu, Xu, Xu, Xu, Xu, Xu, Xu, Xu, Xu, Xu
Xu, Xu, Xu, Xu, Xu, Xu, Xu, Xu, Xu, Ql, Ql, Ql, Qlf, Ur^Ii, Qlf^Ii, Ql^Ii, Ql^Ii, Ql, Qlf, Qlf, Xu, Xu, Xu, Xu, Xu, Xu, Xu, Xu, Xu, Xu, Xu, Xu, Xu, Xu, Xu, Xu, Xu, Xu, Xu, Xu, Xu, Xu, Xu, Xu, Xu, Xu
