Xu, Xu, Xu, Xu, Xu, Xu, Xu, Xu, Xu, Xu, Xu, Xu, Xu, Xu, Xu, Xu, Xu, Xu, Xu, Xu, Xu, Xu, Xu, Xu, Xu, Xu, Xu, Xu, Qlf, Ql, Qlf, Xu, Ur, Xu^Ii, Ql^Ii, Qlf, Qlf, Xu, Xu, Xu, Xu, Xu, Xu, Xu, Xu, Xu
Xu, Xu, Xu, Xu, Xu, Xu, Xu, Xu, Xu, Xu, Xu, Xu, Xu, Xu, Xu, Xu, Xu, Xu, Xu, Xu, Xu, Xu, Xu, Xu, Xu, Xu, Xu, Xu, Xu, Ql, Qlf, Qlf, Ur^Ii, Ql^Ii, Ql^Ii, Qlf, Qlf, Xu, Xu, Xu, Xu, Xu, Xu, Xu, Xu, Xu
Xu, Xu, Xu, Xu, Xu, Xu, Xu, Xu, Xu, Xu, Xu, Xu, Xu, Xu, Xu, Xu, Xu, Xu, Xu, Xu, Xu, Xu, Xu, Xu, Xu, Xu, Xu, Xu, Xu, Qlf, Uu^Vu, Ur^Em, Uu^Es, Qlf^Ii, Qlf, Ql, Xu, Xu, Xu, Xu, Xu, Xu, Xu, Xu, Xu, Xu
Xu, Xu, Xu, Xu, Xu, Xu, Xu, Xu, Xu, Xu, Xu, Xu, Xu, Xu, Xu, Xu, Xu, Xu, Xu, Xu, Xu, Xu, Xu, Uh^Em, Uh, Xu, Xu, Uh^Em, Uu, Uh^Emf, Uu^Uf, Rb^Emf, Ce^Es, Uh, Uu^Uf, Xu, Xu, Xu, Xu, Xu, Xu, Xu, Xu, Xu, Xu, Xu
Xu, Xu, Xu, Xu, Xu, Xu, Xu, Xu, Xu, Xu, Xu, Xu, Xu, Xu, Xu, Xu, Xu, Xu, Xu, Xu, Xu, Xu, Xu, Xu, Uu^Es, Uh^Emf, Qlf, Ql, Ql, Uh^Emf, Uh, Rb, Ce, 1 Ket, Ce, Xu, Uh^Em, Xu, Xu, Xu, Xu, Xu, Xu, Xu, Xu, Xu
Xu, Xu, Xu, Xu, Xu, Xu, Xu, Xu, Xu, Xu, Xu, Xu, Xu, Xu, Xu, Xu, Xu, Xu, Xu, Xu, Xu, Xu, Xu, Uh, Qlf, Qlf, Qlf^Ii, Hhd^Ii, Mv^Ii, Qlf^Ii, Qlf^Ii, Ur^Es, Ur, Ce^Es, Uu^Uf, Uu^Vu, Xu, Uh^Emf, Xu, Xu, Xu, Xu, Xu, Xu, Xu, Xu
Xu, Xu, Xu, Xu, Xu, Xu, Xu, Xu, Xu, Xu, Xu, Xu, Xu, Xu, Xu, Xu, Xu, Xu, Xu, Xu, Xu, Xu, Xu, Xu, Ql, Ql, Md^Ii, Md, Md^Ii, Md^Ii, Md^Ii, Uu, Ur^Em, Uu, Uu^Es, Uh, Uh, Uu^Uf, Xu, Xu, Xu, Xu, Xu, Xu, Xu, Xu
Xu, Xu, Xu, Xu, Xu, Xu, Xu, Xu, Xu, Xu, Xu, Xu, Xu, Xu, Xu, Xu, Xu, Xu, Xu, Uh^Emf, Uh, Xu, Xu, Xu, Xu, Qlf^Ii, Uh^Ii, Md^Ii, Uh, Hhd, Qlf, Uu^Vu, Uh, Rb, Rb^Emf, Uu^Em, Uu, Uu^Emf, Uh, Xu, Qlf, Uu^Uf, Uh^Em, Xu, Xu, Xu
Xu, Xu, Xu, Xu, Xu, Xu, Xu, Xu, Xu, Xu, Xu, Xu, Xu, Xu, Xu, Xu, Xu, Uh^Em, Uh^Emf, Uu^Emf, Xu, Uu^Uf, Xu, Xu, Qlf, Qlf, Qlf, Qlf, Xu, Ql, Ql, Qlf, Uh^Ii, Uh^Ii, Ur, Uh, Qlf, Uu^Uf, Ql, Xu, Ql^Ii, Ql, Qlf, Xu, Xu, Xu
Xu, Xu, Xu, Xu, Xu, Xu, Xu, Xu, Uh, Xu, Xu, Xu, Xu, Xu, Xu, Xu, Xu, Xu, Uu^Uf, Xu, Xu, Uu^Emf, Rb^Em, Qlf, Uh, Uh, Uu^Em, Xu, Xu, Ql, Qlf^Ii, Qlf^Ii, Uh^Ii, Uu^Uf, Ur^Es, Uh^Emf, Uu^Es, Qlf, Uh, Ql^Ii, Qlf^Ii, Xu, Qlf, Uu^Emf, Uh, Xu
Xu, Xu, Uh, Xu, Xu, Xu, Xu, Xu, Uu, Uh^Es, Xu, Xu, Xu, Xu, Xu, Xu, Xu, Xu, Xu, Uu^Uf, Rb, Rb^Es, Uu^Emf, Rb^Es, Uu, Ur, Ur^Es, Uh, Uh, Qlf, Uh, Uu^Uf, Uh^Es, Uh^Em, Ur^Es, Uu^Vu, Uu^Em, Uu^Uf, Uh, Ql, Xu, Qlf^Ii, Uh^Emf, Xu, Xu, Xu
Xu, Xu, Uh^Es, Xu, Xu, Xu, Uh^Ii, Qxu^Ii, Qxu, Qxu, Xu, Xu, Uu^Uf, Xu, Uh, Xu, Xu, Xu, Uh^Emf, Uh, Ur, Uu^Uf, Uh^Emf, Uh, Uh, Ur^Emf, Ur, Uh, Uu^Uf, Rb^Es, Ur^Es, Uu, Rb^Es, Rb, Uu^Emf, Uu^Uf, Uu^Uf, Uh, Xu, Xu, Xu, Uh, Uu^Ufi, Uh^Ii, Uu^Uf, Xu
Uh, Uh^Emf, Uh, Uh^Es, Uu^Vu, Uu^Uf, Uu^Emf, Qxu^Ii, Qxu, Xu, Xu, Uh, Qxu, Uh^Es, Qxu, Xu, Xu, Uh, Uh^Es, Uu^Uf, Ur, Ur, Xu, Xu, Uh, Qlf, Uu^Uf, Uh^Es, Uu^Ufi, Uh^Em, Uu^Uf, Ur^Emf, Ce^Em, Ce, Uu^Uf, Uu, Uh, Uh^Es, Uh, Xu, Xu, Xu, Xu, Xu, Xu, Xu
Uu^Uf, Uu^Vu, Uu^Emf, Uu, Cte^Es, Uu^Uf, Uu^Es, Uh, Uu^Uf, Uh, Uu^Emf, Uu^Uf, Qxu, Qxu, Uu^Uf, Qxu, Xu, Xu, Uh, Uu^Emf, Rb^Em, Uu^Uf, Uh, Uu, Qlf, Qlf, Ql^Ii, Qlf^Ii, Qlf^Ii, Uu^Vu, Uh, Uu, Uh^Emf, 5 Ket, Ur^Em, Uu^Emf, Xu, Uh, Xu, Xu, Xu, Xu, Xu, Xu, Xu, Xu
Uu^Ii, Uu^Ii, Cte^Ii, 4 Kte, Cte^Es, Uu, Uu^Emf, Uu^Ii, Rb^Ii, Uu, Rb^Em, Qxu, Qxu, Uu^Emf, Uu^Uf, Uh^Es, Uh, Xu, Xu, Uh, Ur^Es, Uh, Uh^Es, Qlf, Qlf, Ql^Ii, Qlf^Ii, Ql, Ql, Ql, Qlf, Uh, Qlf, Uu, Uu^Es, Uh^Es, Xu, Xu, Xu, Xu, Xu, Xu, Xu, Xu, Xu, Xu
Uh^Es, Rb^Ii, Uu^Uf, Cte^Em, Uh, Uu^Uf, Uu^Uf, Uu^Ufi, Uu^Ii, Rb^Ii, Uu^Vu, Qxu, Rb, Qxu, Uu^Vu, Uh^Emf, Xu, Xu, Xu, Uh, Uu^Uf, Rb, Uh, Qlf, Uu^Uf, Qlf, Qlf, Ql, Qlf, Qlf, Uu^Es, Qlf, Xu, Qlf, Uu^Em, Uu, Uh^Em, Xu, Xu, Xu, Xu, Xu, Xu, Xu, Xu, Xu
Xu, Uh^Emf, Uh, Uh^Es, Uu^Vu, Uh, Xu, Uh^Emf, Uh, Uh^Ii, Uu^Uf, Uu^Es, Uh^Emf, Rb^Es, Uu, Uh^Es, Uh, Xu, Qlf^Ii, Ur^Em, Uu^Uf, Rb^Emf, Ur, Uh, Ur, Uu^Vu, Uu^Uf, Ql, Ql, Uh, Uu^Uf, Xu, Qlf, Qlf, Xu, Uu^Uf, Uh^Emf, Xu, Xu, Xu, Xu, Xu, Xu, Xu, Xu, Xu
Xu, Uh, Xu, Uu, Uh, Xu, Xu, Uh, Xu, Uu^Uf, Uu^Uf, Uh, Uh, Xu, Xu, Uh, Md, Uu^Ii, Ql^Ii, Qlf, Qlf, Uh, Uh^Es, Uu, Uh^Emf, Ur^Es, Uu^Emf, Uh, Qlf, Ql, Ql^Ii, Ql, Ql^Ii, Xu, Xu, Uh, Xu, Xu, Xu, Xu, Xu, Xu, Xu, Xu, Xu, Xu
Xu, Xu, Xu, Xu, Uh, Xu, Xu, Xu, Uu, Uu^Es, Uh, Rb^Es, Rb, Xu, Uu^Vu, Hhd^Ii, Md^Ii, Mv^Ii, Md^Ii, Ql, Ql, Ql, Qlf, Uu^Uf, Chr, Ch^Em, Ch^Emf, Uh, Uh, Qlf, Md, Md^Ii, Hhd, Uh, Xu, Xu, Xu, Xu, Xu, Xu, Xu, Xu, Xu, Xu, Xu, Xu
Xu, Xu, Xu, Uh, Uh, Xu, Xu, Uh, Qlf, Uu^Uf, Uh^Em, Uu^Emf, Rb, Uh, Uu, Rb^Em, Md, Md, Qlf, Ql^Ii, Uh^Ii, Qlf, Uh^Ii, Uh^Emf, Ch^Em, 3 Kte^Es, Chr, Uh^Emf, Uu^Uf, Qlf, Md^Ii, Mv^Ii, Md^Ii, Md, Qlf, Qlf, Qlf, Xu, Xu, Xu, Xu, Xu, Xu, Xu, Xu, Xu
Qlf, Xu, Xu, Xu, Uu^Uf, Uh, Xu, Xu, Qlf, Qlf, Uu, Uu, Uh^Ii, Xu, Xu, Rb^Es, Rb, Qlf, Uu^Em, Uu^Emf, Ur^Emf, Uh^Ii, Uu^Vu, Uh^Ii, Uu, Rb, Uu^Uf, Uh^Es, Uh, Qlf^Ii, Md, Md^Ii, Uh^Ii, Hhd, Qlf, Xu, Qlf, Xu, Xu, Xu, Xu, Xu, Xu, Xu, Xu, Xu
Ql, Ql, Xoc, Uu^Uf, Uu, Xu, Ql, Ql, Ql, Uh, Uu, Uu^Uf, Uu^Ii, Uh^Ii, Uh^Ii, Uh, Uh, Uu^Uf, Rb^Emf, Ur^Emf, Uu^Uf, Ur^Ii, Ur, Ur^Em, Uh^Emf, Uu^Uf, Uh^Emf, Uh^Em, Uu^Vu, Qlf, Qlf, Qlf, Xu, Uh, Ql, Ql, Ql, Qlf, Uh^Em, Uu^Es, Xu, Xu, Xu, Xu, Xu, Xu
Xoc, Xoc, Uu^Ii, Xoc, Xoc, Xoc, Md^Ii, Mv^Ii, Md^Ii, Uh^Ii, Uh^Ii, Uh, Uh^Es, Uh^Ii, Rb^Ii, Uu^Vu, Rb^Em, Rb^Es, Uu^Ii, Uu^Uf, Uh, Uu^Emf, Uh^Ii, Uu^Uf, Qlf, Uh, Qlf, Uu, Uh^Es, Uu^Es, Ql, Qlf, Xu, Xu, Qlf, Qlf, Qlf, Qlf, Qlf, Uh^Emf, Xu, Xu, Xu, Xu, Xu, Xu
Hhd, Rr^Vd, Uu^Em, Rr, Rr^Ii, Md, Hhd^Es, Md^Ii, Hhd^Em, Chr^Emf, Ur, Rr^Vd, Rb, Rb, Uu^Ii, Ur, Uu^Vu, Uu^Uf, Uu^Ufi, Uu^Emf, Qlf, Xu, Xu, Qlf, Qlf, Ql, Ql^Ii, Qlf, Ql, Uh^Em, Ql, Xu, Qlf, Xu, Xu, Uh, Xu, Qlf, Xu, Xu, Xu, Xu, Xu, Xu, Xu, Xu
Uu^Ufi, Rr^Ii, Ch^Ii, Ch^Ii, Ch^Ii, Uu^Ii, Rr^Ii, Md^Ii, Hhd^Ii, Uu^Es, Uu^Ii, Uh, Uh^Ii, Uu^Uf, Uu^Ufi, Uh, Ql, Uu^Ufi, Ql^Ii, Qlf, Ql, Xu, Ql, Ql, Ql, Ql, Ql^Ii, Ql^Ii, Uu^Es, Ql, Ql, Qlf, Qlf, Xu, Xu, Xu, Xu, Xu, Xu, Xu, Xu, Xu, Xu, Xu, Xu, Xu
Rr^Ii, Hhd^Ii, Ch^Ii, 2 Khr^Ii, Chr^Em, Hhd^Ii, Rr^Ii, Ch, Hhd^Ii, Xoc, Hhd, Uh^Ii, Uh, Uh^Ii, Ql, Ql, Xu, Qlf, Qlf, Ql, Qlf^Ii, Ql, Ql, Qlf, Ql, Qlf^Ii, Qlf, Uh^Ii, Uh, Qlf, Ql, Qlf, Qlf, Xu, Qlf, Xu, Uh, Xu, Xu, Xu, Xu, Xu, Xu, Xu, Xu, Xu
Uu, Rr^Emf, Hhd^Ii, Ch^Es, Uh^Emf, Uu^Ii, Rr^Vd, Rr, Xoc, Uu^Ii, Md^Ii, Mv^Ii, Md, Qlf, Ql, Qlf, Qlf, Xu, Uh^Emf, Qlf, Ql^Ii, Ql^Ii, Ql, Qlf, Qlf, Qlf, Xu, Qlf, Xu, Ql, Ql^Ii, Ql, Qlf^Ii, Qlf, Uh^Es, Uu^Emf, Uh^Emf, Xu, Xu, Xu, Xu, Xu, Xu, Xu, Xu, Xu
Xoc, Hhd^Ii, Hhd^Ii, Rr^Ii, Hhd^Ii, Xoc, Xoc, Ql, Ql, Md, Md, Md, Md, Qlf, Ql, Ql, Ql, Uh^Em, Ql, Ql, Ql, Xu, Xu, Xu, Xu, Xu, Xu, Xu, Xu, Ql, Qlf, Ql^Ii, Qlf^Ii, Qlf, Qlf, Uu^Em, Uu^Uf, Uh, Xu, Xu, Xu, Xu, Xu, Xu, Xu, Xu
Ql, Xoc, Ql, Rr^Vd, Ql, Ql, Uh, Uh, Ql, Qlf, Uh, Hhd, Ql, Ql, Qlf^Ii, Uh, Uh, Ql, Ql, Xu, Xu, Xu, Xu, Xu, Xu, Xu, Xu, Xu, Xu, Xu, Qlf, Ql, Ql, Qlf^Ii, Qlf, Qlf, Uh, Xu, Xu, Xu, Xu, Xu, Xu, Xu, Xu, Xu
Qlf, Ql, Ql^Ii, Ql^Ii, Qlf^Ii, Ql^Ii, Qlf, Uh, Ql, Uu, Ql, Uh, Ql^Ii, Ql, Ql^Ii, Uh^Ii, Qlf, Ql, Qlf, Xu, Xu, Xu, Xu, Xu, Xu, Xu, Xu, Xu, Xu, Qlf, Xu, Qlf, Xu, Qlf, Xu, Xu, Xu, Xu, Xu, Xu, Xu, Xu, Xu, Xu, Xu, Xu
Qlf, Ql, Ql, Ql^Ii, Ql^Ii, Qlf^Ii, Ql, Ql, Uh, Ql, Ql, Ql^Ii, Ql, Ql^Ii, Ql, Uh, Uh^Em, Qlf, Xu, Xu, Xu, Xu, Xu, Xu, Xu, Xu, Xu, Xu, Xu, Xu, Xu, Xu, Xu, Xu, Xu, Xu, Xu, Xu, Xu, Xu, Xu, Xu, Xu, Xu, Xu, Xu
Xu, Qlf, Uh, Ql^Ii, Qlf, Uh, Xu, Ql, Uu, Qlf, Qlf, Ql, Qlf, Qlf, Qlf, Qlf, Uu^Uf, Uu^Emf, Uh, Xu, Xu, Xu, Xu, Xu, Xu, Xu, Xu, Xu, Xu, Xu, Xu, Xu, Xu, Xu, Xu, Xu, Xu, Xu, Xu, Xu, Xu, Xu, Xu, Xu, Xu, Xu
Xu, Xu, Qlf, Qlf, Uu^Es, Uu^Uf, Xu, Xu, Xu, Xu, Xu, Xu, Uh, Qlf, Qlf, Uh, Uh^Em, Uu, Uh^Emf, Xu, Xu, Xu, Xu, Xu, Xu, Xu, Xu, Xu, Xu, Xu, Xu, Xu, Xu, Xu, Xu, Xu, Xu, Xu, Xu, Xu, Xu, Xu, Xu, Xu, Xu, Xu
Xu, Uh, Uh^Em, Xu, Xu, Uh, Xu, Xu, Xu, Xu, Xu, Xu, Xu, Uh, Xu, Uh^Emf, Xu, Uu^Uf, Xu, Xu, Xu, Xu, Xu, Xu, Xu, Xu, Xu, Xu, Xu, Xu, Xu, Xu, Xu, Xu, Xu, Xu, Xu, Xu, Xu, Xu, Xu, Xu, Xu, Xu, Xu, Xu
Xu, Xu, Xu, Xu, Xu, Xu, Xu, Xu, Xu, Xu, Xu, Xu, Xu, Xu, Xu, Xu, Xu, Xu, Xu, Xu, Xu, Xu, Xu, Xu, Xu, Xu, Xu, Xu, Xu, Xu, Xu, Xu, Xu, Xu, Xu, Xu, Xu, Xu, Xu, Xu, Xu, Xu, Xu, Xu, Xu, Xu
