Xu, Xu, Xu, Xu, Xu, Xu, Xu, Xu, Xu, Xu, Xu, Xu, Xu, Xu, Xu, Xu, Xu, Xu, Xu, Xu, Xu, Xu, Xu, Xu, Xu, Xu, Xu, Xu, Xu, Xu, Xu, Xu, Xu, Xu, Xu
Xu, Xu, Xu, Xu, Xu, Xu, Xu, Xu, Xu, Xu, Xu, Xu, Xu, Xu, Xu, Xu, Xu, Xu, Xu, Xu, Xu, Xu, Xu, Xu, Xu, Xu, Xu, Xu, Xu, Xu, Xu, Xu, Xu, Xu, Xu
Xu, Xu, Xu, Xu, Xu, Xu, Xu, Xu, Xu, Xu, Xu, Xu, Xu, Xu, Xu, Xu, Xu, Xu, Xu, Xu, Xu, Xu, Xu, Xu, Xu, Xu, Xu, Xu, Xu, Xu, Xu, Xu, Xu, Xu, Xu
Xu, Xu, Xu, Xu, Xu, Xu, Xu, Xu, Xu, Xu, Xu, Xu, Xu, Xu, Xu, Xu, Xu, Xu, Xu, Xu, Xu, Xu, Xu, Xu, Xu, Xu, Xu, Xu, Xu, Xu, Xu, Xu, Xu, Xu, Xu
Xu, Xu, Xu, Xu, Xu, Xu, Xu, Xu, Xu, Xu, Xu, Xu, Xu, Xu, Xue, Uu^Uf, Uu^Emf, Uh^Em, Uu^Emf, Xu, Xu, Xu, Xu, Xu, Xu, Xu, Xu, Xu, Xu, Xu, Uh, Xu, Xu, Uu^Uf, Sm
Xu, Xu, Xu, Xu, Xu, Xu, Xu, Xu, Xu, Xu, Sm, Uu^Uf, Uh^Em, Uh^Emf, Kte^Em, Ur, Uu, Uh^Ii, Uh^Ii, Xu, Sm, Uh^Es, Xu, Xu, Xu, Xu, Xu, Xu, Xu, Xu, Ss, Uh^Es, Cer^Emf, Ss, Uh^Es
Xu, Xu, Xu, Xu, Xu, Xu, Xu, Xu, Xu, Wwf^Es, Wwf^Ii, Uh^Ii, Wog^Ii, Ww^Ii, Ww, Cte, Ww, Ww^Ii, Wwf^Es, Wwf^Ii, Wwf^Ii, Uu^Uf, Uu^Emf, Xu, Xu, Xu, Ss, Ss^Vhs, Wwf^Es, Uh^Emf, Sm, Cer, 3 Kte, Cte, Uu
Xu, Xu, Xu, Xu, Uh, Uh, Xu, Xu, Xu, Xu, Ww, Ww^Ii, Wo, Ww^Ii, Ww, Gg^Efm, Gs^Vc, Cte^Es, Gll^Fp, Gs^Es, Gs^Fds, Ww, Xu, Xu, Xu, Xu, Sm, Sm, Uu^Uf, Wwg, Uh, Cte^Es, Uu^Emf, Cte^Em, Uh
Xu, Xu, Uh^Ecf, Xu, Uu^Vu, Uu, Uu^Uf, Uu^Vu, Uh, Wo, Wo, Gs^Vc, Gs^Fms, Gll^Fp, Gs^Fms, Gs^Gvs, Cte, Gg^Fet, Gs^Fms, Gll^Em, Gs^Fms, Wog^Ii, Xu, Xu, Xu, Uh, Wwf, Uh^Ecf, Uu^Vu, Sm, Wwf^Es, Uu^Uf, Rb, Uh^Ecf, Xu
Uu^Uf, Uh^Emf, Ur, Uu^Emf, Uu, Uu^Em, Cte, Uu^Em, Uh^Ecf, Xu, Wo^Ii, Gs^Efm, Gs^Fds, Cte, Cte^Emf, 2 Kte, Cte^Em, Gs^Fds, Gs^Fds, Gg, Wwf, Ww^Ii, Wwf^Ii, Uh^Emf, Ss, Uu^Uf, Sm, Ss, Uh, Cer^Em, Uu^Emf, Wwf, Uh^Em, Uu^Emf, Xu
Ur^Em, Uu^Uf, Uu^Vu, Rb^Em, Cer, 4 Ker, Cte, Ur^Es, Uu, Rb^Em, Ww^Ii, Ww^Ii, Wo, Gg^Gvs, Gll^Fp, Cte^Es, Wwf^Es, Wwf^Es, Gs^Vc, Gs^Efm, Cte^Em, Wwf^Es, Uh^Em, Uh^Dr, Ss, Sm, Uh, Wwf, Sm, Ss, Uu^Ecf, Uu^Uf, Sm, Sm, Ss
Xu, Uh, Ss, Uh^Emf, Uh^Ecf, Cer^Em, Uu^Uf, Uu^Emf, Uu^Em, Uu, Wwf^Es, Ww^Ii, Wo^Ii, Gll, Gs^Fds, Gs^Fds, Wwf^Ii, Wwf^Es, Wo^Ii, Wo^Ii, Ur^Emf, Uu^Uf, Rb, Ss, Uh, Uu^Emf, Rb, Rb^Em, Uu^Vu, Uu^Uf, Rb, Rb^Em, Ss^Vhs, Uu^Uf, Ur
Xu, Xu, Ss, Ss, Sm, Uu^Vu, Wwg, Wwf, Wwf^Es, Uh, Uu^Emf, Uu^Uf, Wwf^Ii, Wo^Ii, Ww, Wwf^Es, Wwf^Ii, Ww^Ii, Cte^Ii, Ww^Ii, Uu^Vu, Rb, Uh^Emf, Ur^Em, Ur, Uu^Uf, Uh, Rb^Emf, Ur, Ur^Es, Uu^Emf, Sm, Ss, Ss, Uu
Xu, Uu^Uf, Ss, Sm, Ss, Sm, Wwf^Es, Wwg, Wwf^Es, Uh, Uu^Es, Rb^Es, Rb^Em, Uh^Emf, Uh, Sm, Uh, Sm, Rb^Em, Wwf, Wwf, Uu^Em, Uu^Uf, Uu^Emf, Uu, Uh, Uu^Uf, Uu^Emf, Uu, Uh, Wwf, Sm, Sm, Ss, Ss
Xu, Uh, Uh, Ss, Xu, Uu^Uf, Uh^Es, Sm, Uh^Emf, Wwf, Xu, Uu, Qxu, Uh^Es, Qxu, Uu^Emf, Uu, Rb^Es, Rb, Uh, Uh^Em, Qxu, Wwg, Wwf^Es, Wwf, Wwg, Wwf^Es, Wwf, Sm, Sm, Sm, Wwf^Es, Xu, Ss, Xu
Xu, Xu, Xu, Xu, Xu, Uh, Sm, Sm, Xu, Xu, Xu, Xu, Qxu, Qxu, Wwf, Qxu, Uu^Em, Uu, Ur, Uh^Es, Wwf^Ii, Qxu^Ii, Qxu, Qxu, Qxu, Xu, Sm, Wwf^Es, Sm, Sm, Xu, Ss, Xu, Xu, Xu
Xu, Xu, Xu, Xu, Xu, Wwf, Wwf^Es, Sm, Xu, Xu, Xu, Uh, Uh^Em, Qxu, Wwf^Es, Wwf^Es, Uh^Em, Uu^Es, Uu^Uf, Rb^Ii, Uh^Ii, Uh^Ii, Uu^Uf, Xu, Xu, Xu, Xu, Wwg, Wwg, Xu, Xu, Xu, Qlf, Xu, Xu
Xu, Xu, Uu^Uf, Ss, Ss^Ii, Uh^Emf, Wwg, Ss, Ss, Xu, Xu, Xu, Xu, Uh^Es, Uu^Emf, Uh, Uu^Uf, Uu, Uu^Vu, Ur^Em, Ur, Rb^Ii, Rb^Emf, Uu^Vu, Uh^Es, Uh, Qxu, Wwg, Qxu, Qxu, Qxu^Ii, Qxu, Qlf^Ii, Qlf, Ql
Xu, Xu, Xu, Uu^Es, Sm^Ii, Sm^Ii, Sm, Sm, Xu, Xu, Uu^Uf, Xu, Ss, Uu^Es, Wwg, Uu^Es, Uh, Uu, Xu, Uu^Uf, Sm, Rb^Emf, Ur^Es, Rb^Em, Uu^Emf, Wwf, Qxu, Qxu, Qxu^Ii, Qxu, Uh^Ii, Ql^Ii, Ql^Ii, Ql, Qlf
Xu, Xu, Ss, Ss, Ss, Sm, Xu, Wwf, Uu^Ii, Uh, Wwf^Ii, Sm, Uh, Uh^Em, Xu, Xu, Xu, Xu, Xu, Sm, Wwf, Uu^Vu, Uh, Uu^Uf, Uh, Chr, 1 Ke, Rr^Ii, Uh^Ii, Uu^Emf, Rr^Es, Rr, Rr^Em, Uu^Es, Uh^Emf
Xu, Xu, Xu, Xu, Xu, Wwg, Wwf^Ii, Uh^Ii, Sm^Ii, Uu^Ii, Uu^Ufi, Sm, Uh, Uh^Emf, Ss, Xu, Xu, Xu, Xu, Uh^Em, Xu, Uu^Em, Uh^Emf, Uh^Es, Uu^Em, Ce^Ii, Ce^Ii, Uh^Ii, Qxu, Rr^Vd, Rr^Emf, Uu, Uh^Ii, Uu^Ufi, Uu
Xu, Xu, Xu, Xu, Xu, Uh^Emf, Sm, Uu^Ii, Wwf^Ii, Uu^Emf, Sm, Uh^Em, Uh^Es, Xu, Xu, Ss, Xu, Xu, Xu, Xu, Xu, Uu^Uf, Xu, Xu, Uh^Emf, Uu^Uf, Qxu, Qxu, Qxu, Uh, Qxu, Uh^Ii, Qlf^Ii, Uh^Ii, Qlf
Xu, Xu, Xu, Uh^Em, Ss, Uu^Uf, Ss, Sm, Uh^Es, Ss, Ss, Ss, Uh, Xu, Xu, Xu, Xu, Xu, Xu, Xu, Xu, Xu, Xu, Xu, Xu, Uh, Xu, Qxu, Qxu, Qxu, Ql, Ql^Ii, Ql, Qlf, Ql
Xu, Xu, Xu, Xu, Xu, Xu, Xu, Xu, Wwg, Xu, Xu, Xu, Xu, Xu, Xu, Xu, Xu, Xu, Xu, Xu, Xu, Xu, Xu, Xu, Xu, Xu, Xu, Xu, Xu, Xu, Xu, Ql, Qlf, Xu, Qlf
Xu, Xu, Xu, Xu, Xu, Xu, Xu, Xu, Xu, Xu, Xu, Xu, Xu, Xu, Xu, Xu, Xu, Xu, Xu, Xu, Xu, Xu, Xu, Xu, Xu, Xu, Xu, Xu, Xu, Xu, Xu, Qlf, Xu, Qlf, Xu
