Xu, Xu, Xu, Xu, Xu, Xu, Xu, Xu, Xu, Xu, Xu, Xu, Xu, Xu, Xu, Xu, Xu, Xu, Xu, Xu, Xu, Xu, Xu, Xu, Xu, Xu, Xu, Xu, Xu, Xu, Xu, Xu, Xu, Xu, Xu
Xu, Xu, Xu, Xu, Xu, Xu, Xu, Xu, Xu, Xu, Xu, Xu, Xu, Xu, Xu, Xu, Xu, Xu, Xu, Xu, Xu, Xu, Xu, Xu, Xu, Xu, Xu, Xu, Xu, Xu, Xu, Xu, Xu, Xu, Xu
Xu, Xu, Xu, Xu, Xu, Xu, Xu, Xu, Xu, Xu, Xu, Xu, Xu, Xu, Xu, Xu, Xu, Xu, Xu, Xu, Xu, Xu, Xu, Xu, Xu, Xu, Xu, Xu, Xu, Xu, Xu, Xu, Xu, Xu, Xu
Xu, Xu, Xu, Xu, Xu, Xu, Xu, Xu, Xu, Xu, Xu, Xu, Xu, Xu, Xu, Xu, Xu, Xu, Xu, Xu, Xu, Xu, Xu, Xu, Xu, Xu, Xu, Xu, Xu, Xu, Xu, Xu, Xu, Xu, Uu^Uf
Xu, Xu, Xu, Xu, Xu, Xu, Xu, Xu, Xu, Xu, Xu, Xu, Xu, Xu, Xue, Xu, Xu, Xu, Xu, Xu, Xu, Xu, Xu, Xu, Xu, Xu, Xu, Xu, Xu, Xu, Xu, Xu, Xu, Uu^Uf, Uu
Xu, Xu, Xu, Xu, Xu, Xu, Xu, Xu, Xu, Xu, Xu, Xu, Xue, Xue, Kte, Xue, Xue, Xu, Xu, Xu, Xu, Xu, Xu, Xu, Xu, Xu, Xu, Xu, Xu, Xu, Qxu, Xu, Uh, Uu, Uh
Xu, Xu, Xu, Xu, Xu, Xu, Xu, Xu, Xu, Xu, Xue, Xue, Wog, Wog, Wwg, Wwg, Wwg, Xue, Xue, Xue, Xue, Xu, Xu, Xu, Xu, Xu, Xu, Xu, Xu, Xu, Qxu, Uh, Uh, Qxu, Xu
Xu, Xu, Xu, Xu, Xu, Xu, Xu, Xu, Xu, Xu, Xue, Wwg, Wwg, Ww, Uue, Uu^Vu, Rb, Cte, Uue, Uue, Uue, Xue, Xu, Xu, Xu, Xu, Qxu, Qxu, Uu^Uf, Uu^Uf, Cer, Cer, Cer, Uh, Xu
Xu, Xu, Xu, Xu, Uu^Vu, Uu, Uu^Uf, Uu^Vu, Uh, Xu, Xue, Uu^Vu, Rb, Uue, Rb, Rb, Cte, Rb, Uue, Rb, Uue, Qxe, Qxe, Xu, Xu, Xu, Qxu, Uh, Uu^Vu, Uu^Uf, Uu, 3 Ker, Cer, Uu, Xu
Uu, Uh, Ur, Uu^Uf, Uu, Uu, Cer, Uu, Uh, Xu, Qxe, Uue, Uue, Cte, Cte, 2 Kte, Cte, Uue, Uue, Rb, Rb, Qxe, Qxe, Xu, Qxu, Xu, Xu, Qxu, Uh, Cer, Uu^Vu, Uh, Uh, Uu^Vu, Xu
Ur, Rb, Uu^Vu, Rb, Cer, 4 Ker, Cer, Ur, Uu, Rb, Rb, Qxe, Qxe, Rb, Uue, Cte, Wwg, Wwg, Uu^Vu, Rb, Cte, Qxe, Uh, Qxe, Qxu, Qxu, Uh, Qxu, Qxu, Qxu, Uu, Uu^Uf, Qxu, Qxu, Uh
Xu, Uh, Xu, Uh, Uh, Cer, Uu^Uf, Uu, Uu, Uu^Uf, Uu, Uh, Qxu^Bs/, Rb, Rb, Uue, Wwf, Wwg, Wwg, Wwg, Ur, Uu^Uf, Rb, Qxe, Uh, Uu^Uf, Rb, Uu, Uu^Vu, Uu^Uf, Rb, Ur, Ur, Uu^Uf, Ur
Xu, Xu, Xu, Xu, Xu, Xu, Xu, Xu, Qxe, Qxe, Uu, Uu^Uf, Uh, Qxe, Qxe, Wwf, Qxe, Wwf, Cte, Ur, Uu^Vu, Ur, Uh, Ur, Ur, Ur, Uh, Ur, Ur, Ur, Uu, Uu^Uf, Uu^Uf, Qxu, Uu
Xu, Xu, Xu, Xu, Xu, Xu, Xu, Xu, Qxe, Qxe, Qxe, Uu, Uu, Uh, Uu, Qxe, Uh, Qxe, Rr, Uu, Qxu, Uu, Uu^Uf, Uu^Uf, Uu, Uu, Uu^Uf, Uu, Uu, Uh, Uh, Qxu, Qxu, Qxu, Xu
Xu, Xu, Xu, Xu, Xu, Xu, Xu, Xu, Xu, Qxe, Xu, Uu, Uu^Uf, Uh, Qxe, Uu, Uu^Uf, Uu, Rr, Uh, Qxu, Qxu, Qxu, Qxu, Qxu, Qxu, Qxu, Qxu, Qxu, Uh, Xu, Qxu, Xu, Xu, Xu
Xu, Xu, Xu, Xu, Xu, Xu, Xu, Xu, Xu, Xu, Xu, Xu, Uu, Qxe, Qxe, Qxe, Qxu, Uu, Rr, Uu^Uf, Qxu, Qxu, Qxu, Qxu, Xu, Xu, Qxu, Qxu, Xu, Xu, Xu, Xu, Xu, Xu, Xu
Xu, Xu, Xu, Xu, Xu, Xu, Xu, Xu, Xu, Xu, Xu, Xu, Xu, Uu^Uf, Uu, Qxe, Uh, Uu, Uu^Uf, Rb, Uh, Uh, Uu^Uf, Xu, Xu, Xu, Xu, Xu, Xu, Xu, Xu, Xu, Xu, Xu, Xu
Xu, Xu, Xu, Xu, Xu, Xu, Xu, Xu, Xu, Xu, Xu, Xu, Xu, Xu, Xu, Uh, Xu, Uu, Uu^Vu, Rr, Rr, Rr, Rb, Uu^Vu, Uh, Xu, Xu, Xu, Ql, Xu, Ql, Xu, Ql, Xu, Ql
Xu, Xu, Xu, Xu, Xu, Xu, Xu, Xu, Xu, Xu, Xu, Xu, Xu, Xu, Xu, Xu, Xu, Xu, Xu, Uu^Uf, Uu, Uu, Uh, Rr, Rr, Xu, Ql, Ql, Ql, Ql, Ql, Ql, Ql, Ql, Ql
Xu, Xu, Xu, Xu, Xu, Xu, Xu, Xu, Xu, Xu, Xu, Xu, Xu, Xu, Xu, Xu, Xu, Xu, Xu, Xu, Xu, Uu, Uu, Uu^Uf, Uh, Ch, 1 Kh, Rr^Ii, Rr^Ii, Rr^Ii, Rr^Ii, Rr^Ii, Rr^Ii, Rr^Ii, Rr^Ii
Xu, Xu, Xu, Xu, Xu, Xu, Xu, Xu, Xu, Xu, Xu, Xu, Xu, Xu, Xu, Xu, Xu, Xu, Xu, Xu, Xu, Xu, Xu, Xu, Xu, Ch, Ch, Rrc^Ii, Rr^Ii, Rrc^Ii, Rr^Ii, Rrc^Ii, Rr^Ii, Rrc^Ii, Rr^Ii
Xu, Xu, Xu, Xu, Xu, Xu, Xu, Xu, Xu, Xu, Xu, Xu, Xu, Xu, Xu, Xu, Xu, Xu, Xu, Xu, Xu, Xu, Xu, Xu, Xu, Xu, Ql, Rr^Ii, Ql, Rr^Ii, Ql, Rr^Ii, Ql, Rr^Ii, Ql
Xu, Xu, Xu, Xu, Xu, Xu, Xu, Xu, Xu, Xu, Xu, Xu, Xu, Xu, Xu, Xu, Xu, Xu, Xu, Xu, Xu, Xu, Xu, Xu, Xu, Xu, Xu, Ql, Ql, Ql, Ql, Ql, Ql, Ql, Ql
Xu, Xu, Xu, Xu, Xu, Xu, Xu, Xu, Xu, Xu, Xu, Xu, Xu, Xu, Xu, Xu, Xu, Xu, Xu, Xu, Xu, Xu, Xu, Xu, Xu, Xu, Xu, Xu, Xu, Xu, Xu, Xu, Xu, Xu, Xu
Xu, Xu, Xu, Xu, Xu, Xu, Xu, Xu, Xu, Xu, Xu, Xu, Xu, Xu, Xu, Xu, Xu, Xu, Xu, Xu, Xu, Xu, Xu, Xu, Xu, Xu, Xu, Xu, Xu, Xu, Xu, Xu, Xu, Xu, Xu
